1111111
10X00P1
10000X1
1000CE1
1111111