1111111111111
1E1CC00010001
10101110000X1
101C001010001
1011101011001
101C001000001
101C111111101
1010001010001
1010101010111
1C10101C10101
1011101010101
101C0C1010001
1010111011101
1000101000101
1111101010101
100000101C001
1011101011111
1P01000000X11
1111111111111