1111111111111111111111111111
1XXXX0000000000C000000000001
1000011011110111101111100001
1C00001000010000100XX0100001
1C0000101111P111100000100001
10000010000100C010000010C001
1C00001011110111100000E00001
1000X0000000000000X000000001
1111111111111111111111111111