111111111111111111111111
100000000000000000001111
100000000000000000001111
100000000000100000001111
100000000001C10000001101
100000000000000000001111
111100000000000000001111
1P0E00001000000000001111
111111111111111111111111