1111111111111
1E1CC0001XXX1
101011101X1X1
101C00101X1X1
10111010111X1
101C001000001
101C111111101
1010001X10001
1010101010111
1C10101C10101
10111010101X1
101C0C1010001
1010111011101
1000101000101
1111101010101
100000101C001
1011101011111
1P001000XXXX1
1111111111111