1111111111111111111111111111
1XXXX0000000000C000000000001
1000001011110111101111100001
1C00011000010000100XX1000001
1C0010101111P111100010000001
10000010000100C010001000C001
1C000010111101111000E0000001
1000X0000000000000X000000001
1111111111111111111111111111