1111111111111111111111111111111111111111
1P0EC0000000000000000000000000C111111111
1011111111111111111111111111111111111111
1011111111111111111111111111111111111111
1011111111111111111111111111111111111111
1011111111111111111111111111111111111111
1011111111111111111111111111111111111111
1011111111111111111111111111111111111111
1011111111111111111111111111111111111111
1011111111111111111111111111111111111111
1011111111111111111111111111111111111111
1011111111111111111111111111111111111111
1011111111111111111111111111111111111111
1011111111111111111111111111111111111111
1011111111111111111111110111111111111111
1011111111111111111111111111111111111111
1011111111111111111111111111111111111111
1011111111111111111111111111111111111111
1C11111111111111111111111111111111111111
1111111111111111111111111111111111111111