11111111111111111111111111111111
10PEC0000010000000001000000000C1
10110000000000100000000000100011
10011111111111111111011111111111
1101000001C000000000000000000001
10010101011111110111111111111101
101101C100000000000000C1C0000101
10010111111111110111111111110101
11010000000000000000000000000101
1C011111111111011111111111111101
11000000000000000000000000000001
11111111111111111111111111111111