11111111111111111111
10C1C0010C0101000101
110C00101C0C00100011
1001C001P00101010001
11111011101111000101
10C0000100C1E1101111
10001001000101000101
11111101100001000101
10000101000101101101
10010100011111000001
1001000100000000C101
11111111101111111111
1001001010000C010001
1000001000C01CC100C1
11110110100010000011
10C00010101110010C01
10001000100010C10001
11111011101111111101
1000000C100010000001
11111111111111111111